Qual é a indicação da Amoxicilina 500 mg?	A Amoxicilina 500 mg é indicada para o tratamento de infecções causadas por bactérias sensíveis à Amoxicilina.
Quais tipos de infecções a Amoxicilina 500 mg pode tratar?	A Amoxicilina 500 mg é indicada para o tratamento de infecções urinárias, de ouvido, respiratórias, amigdalite, sinusite ou vaginite, tanto em adultos quanto em crianças.
Qual é a posologia recomendada para adultos e idosos?	A dose recomendada para adultos é geralmente 250 mg, administrados 3 vezes por dia, de 8 em 8 horas. Pode ser aumentada para 500 mg, 3 vezes ao dia, conforme indicação médica.
Qual é a dose recomendada para crianças até 10 anos?	A dose geralmente recomendada para crianças é de 125 mg, administrados 3 vezes por dia, de 8 em 8 horas. Pode ser aumentada para 250 mg, 3 vezes ao dia, conforme indicação médica.
Como é feito o tratamento da gonorreia com Amoxicilina?	O tratamento da gonorreia é geralmente feito em dose única, com a administração de 3 gramas (equivalente a 6 comprimidos de Amoxicilina 500 mg), de acordo com a indicação médica.
Quais são os possíveis efeitos colaterais da Amoxicilina 500 mg?	Alguns dos possíveis efeitos colaterais incluem diarreia, urticária, bolinhas vermelhas, vermelhidão e coceira na pele.
Quais são as contraindicações para o uso de Amoxicilina 500 mg?	A Amoxicilina 500 mg está contraindicada para pacientes com histórico de alergia a antibióticos betalactâmicos, como penicilinas e cefalosporinas, ou alergia à própria Amoxicilina.
O que é importante verificar antes de usar Amoxicilina 500 mg?	É importante verificar com um médico antes de usar o medicamento se estiver grávida, amamentando, tiver histórico de alergias, problemas nos rins, estiver tomando outros medicamentos, entre outras situações.
O que deve ser feito em caso de reação alérgica durante o tratamento com Amoxicilina?	Caso sinta sintomas de reação alérgica como vermelhidão, coceira, inchaço e urticária na pele, é necessário consultar o médico imediatamente.
Qual é o mecanismo de ação da Amoxicilina?	A Amoxicilina é um antibiótico do grupo das penicilinas que age destruindo várias bactérias sensíveis à substância.
Como a superdosagem de Amoxicilina 500 mg deve ser tratada?	Em caso de superdosagem, é recomendado procurar atendimento médico imediatamente, levando a embalagem ou bula do medicamento.
Qual é a composição da Amoxicilina 500 mg?	Cada cápsula de Amoxicilina 500 mg contém Amoxicilina triidratada equivalente a 500 mg de Amoxicilina anidra, além de excipientes.
O que fazer em caso de esquecimento de uma dose de Amoxicilina 500 mg?	Caso tenha esquecido uma dose, deve tomá-la assim que lembrar. Se estiver próximo ao horário da próxima dose, é melhor pular a dose esquecida.
Quais medicamentos não devem ser usados em conjunto com Amoxicilina?	Amoxicilina não deve ser usada em conjunto com medicamentos para gota, outros antibióticos, pílulas anticoncepcionais ou anticoagulantes, entre outros, sem orientação médica.
Qual é o laboratório fabricante da Amoxicilina 500 mg?	A Amoxicilina 500 mg é fabricada pelo laboratório Ranbaxy Laboratories Limited.
Nome do Medicamento	Amoxicilina 500 mg.
Indicação Principal	Amoxicilina 500 mg é um antibiótico de largo espectro usado para tratar infecções causadas por bactérias sensíveis à Amoxicilina.
Infecções Tratadas	O medicamento é indicado para o tratamento de infecções urinárias, de ouvido, respiratórias, amigdalite, sinusite e vaginite em adultos e crianças.
Dosagem para Adultos	A dose recomendada para adultos é geralmente de 250 mg, administrados 3 vezes ao dia de 8 em 8 horas.
Aumento de Dosagem para Adultos	A dosagem pode ser aumentada para 500 mg, administrados 3 vezes ao dia de 8 em 8 horas, conforme indicação médica.
Dosagem para Crianças até 10 anos	A dose recomendada para crianças até 10 anos é geralmente de 125 mg, administrados 3 vezes ao dia de 8 em 8 horas.
Aumento de Dosagem para Crianças	A dosagem pode ser aumentada para 250 mg, administrados 3 vezes ao dia de 8 em 8 horas, conforme indicação médica.
Tratamento da Gonorreia	O tratamento da gonorreia é geralmente feito em dose única, com a administração de 3 gramas (equivalente a 6 comprimidos de Amoxicilina 500 mg), conforme indicação médica.
Forma de Uso	Os comprimidos de Amoxicilina 500 mg devem ser engolidos inteiros, com um copo de água, sem partir ou mastigar.
Efeitos Colaterais	Alguns efeitos colaterais possíveis incluem diarreia, urticária, bolinhas vermelhas, vermelhidão e coceira na pele.
Contraindicações	Não deve ser usado por pacientes com histórico de alergia a antibióticos betalactâmicos, como penicilinas e cefalosporinas, ou a algum componente da fórmula.
Precauções	É importante consultar um médico antes de usar Amoxicilina 500 mg em crianças, durante a gravidez ou amamentação, em casos de alergias anteriores a antibióticos, problemas renais, entre outros.
Reações Alérgicas	Sintomas de reação alérgica como vermelhidão, coceira, inchaço e urticária na pele devem ser relatados ao médico.
Corante na Composição	A Amoxicilina 500 mg contém o corante amarelo de tartrazina, que pode causar reações alérgicas como asma brônquica em pessoas sensíveis.
Interromper Tratamento	O tratamento com Amoxicilina nunca deve ser interrompido sem o conhecimento do médico, e as doses e duração do tratamento devem ser respeitadas.
Mecanismo de Ação	A Amoxicilina é uma penicilina do grupo dos antibióticos penicilânicos, que destrói uma ampla gama de bactérias sensíveis à substância.
Superdosagem	Em caso de superdosagem, é recomendado procurar um hospital levando a embalagem ou a bula do medicamento.
Composição	Cada cápsula de Amoxicilina 500 mg contém Amoxicilina triidratada equivalente a 500 mg de Amoxicilina anidra e excipientes.
Esquecimento de Dose	Se esquecer uma dose, pode tomá-la assim que lembrar, a menos que esteja próximo do horário da próxima dose.
Interações Medicamentosas	A Amoxicilina não deve ser administrada em conjunto com certos medicamentos sem orientação médica, como medicamentos para gota, outros antibióticos, pílulas anticoncepcionais e anticoagulantes.
Laboratório	O medicamento é fabricado pelo laboratório Ranbaxy Laboratories Limited.
Contato	O SAC (Serviço de Atendimento ao Cliente) do laboratório é 0800 704 7222.
É possível entrar em contato com a empresa?	Sim, pelo O SAC (Serviço de Atendimento ao Cliente) do laboratório é 0800 704 7222
Em quais casos deve-se dirigir ao hospital mais próximo?	Se ocorrer uma superdosagem, ou seja, o uso de uma quantidade maior que a indicada
Enquanto estiver usando o remédio quando é necessário consultar o médico?	caso sinta sintomas de reação alérgica como vermelhidão, coceira, inchaço e urticária na pele