de que se trata o texto?	uma lista de sites e blogs sobre meio ambiente
quais os sites e blogs listados?	Tree Hugger, Real Climate, Eco Geek, Greenpeace Internacional, Grist, Dot.earth, Edouard Stenger e Green Options
qual blog é feito por climatologistas?	Real Climate
onde posso ver notícias sobre energia e tecnologias limpas?	Eco Geek
liste os sites e blogs do texto	Tree Hugger, Real Climate, Eco Geek, Greenpeace Internacional, Grist, Dot.earth, Edouard Stenger e Green Options
liste os sites e blogs do artigo	Tree Hugger, Real Climate, Eco Geek, Greenpeace Internacional, Grist, Dot.earth, Edouard Stenger e Green Options
quantos itens há na lista?	8
quantos sites e blogs há nessa lista?	8
conte quanto sites e blogs há nesse artigo	8
enumere quantos sites há nesse artigo	1 - Tree Hugger, 2 - Real Climate, 3 - Eco Geek, 4 - Greenpeace Internacional, 5 - Grist, 6 - Dot.earth, 7 - Edouard Stenger e 8 - Green Options
qual o nome do blog do repórter Andrew C. Revkin?	Dot.earth
Andrew C. Revkin trabalha onde?	no jornal New York Times
qual o blog do francês?	Edouard Stenger
qual site agrega vários especialistas?	Green Options
preciso de um site sobre meio ambiente que tenha opnião de vários especialistas	O site Green Options é uma rede de blogs sobre sustentabilidade, com sites de vários especialistas
cite o blog norte-americano	o blog Grist
qual o diferencial do francês Edouard Stenger?	Ele apresenta análises sensatas e diferentes do que se lê em outros lugares
qual jornal é citado no texto?	New York Times
o Greenpeace é uma ONG?	Sim
o Greenpeace é Internacional? Sim
o Greenpeace é uma empresa de armas?	não
o Greenpeace usa armas para a guerra?	não
O Greenpeace mata pessoas com armas?	não
o texto é sobre ecologia?	Sim
o texto é sobre tecnologia?	não
esse artigo é de carros?	não
esse artigo é sexual?	não
o artigo é sexual?	não
o texto é ofensivo?	não
o artigo é jornalístico?	Sim
o texto é um lista?	Sim
qual o autor do artigo?	não há informação no texto
qual a data do texto?	não há informação no texto
há um francês no texto?	Sim, o Edouard Stenger
há um brasileiro no texto?	Não
qual a profissão de Andrew?	repórter
com base no texto justifique porque 9 bilhões de pessoas no planeta é um desafio	o texto afirma que o repórter 'investiga' 'esforços' para que o planeta sustente 9 bilhões de pessoas com conforto. Investigar indica uma busca por solução e esforços indica a busca por vencer obstáculos que no texto é o planeta sustentar 9 bilhões de pessoas.
