do que se trata o texto?	é um relato de alguém que ganhou experiência treinando seu próprio modelo de linguagem
do que se trata o texto?	é uma mensagem de alguém dizendo que ganhou experiência treinando sua própria rede transformers
é ele ou ela?	não é possível identificar o sexo do interlocutor
o autor é médico?	possivelmente não, mas o autor usou textos médicos para treinar sua rede neural
o autor é filosofo?	possivelmente não, mas o autor usou textos de filosofia para treinar seu modelo de linguagem
o autor é um repórter?	não é possível afirmar com base nas informações do texto se o autor é um repórter
o autor é um programador?	possivelmente sim
como ele ganhou experiência com IA?	Treinando seu próprio modelo de linguagem em uma rede transformers
porque se pode afirmar que ele treinou um modelo de linguagem?	porque ele usou muitos textos e textos costumam ser usados para treinar modelos de linguagens
o que ele ou ela treinou?	Uma Rede Transformer
a IA que ele fez era inteligente?	Não, ele a considerava burra porém surpreendia com certas respostas
porque a ambiguidade entre considerar a rede burra mas ao mesmo tempo surpreendente?	Não há essa informação no texto, porém infere-se que apesar do modelo de linguagem ter poucos parametros e errar informações as vezes ela surpreende com repostas corretas para uma rede pequena.
quais textos foram usados para treinar?	Textos academicos, filosofia, médico, reportagens, wikipedia, contos de terror, contos eróticos e informações de senso comum.
porque a rede é burra?	o autor justifica por ela ter poucos parametros
uma rede com poucos parametros é burra?	O autor defende que sim.
o que ele botou?	muitos textos
ele botou um ovo?	não
ela botou um ovo?	não
do que ele ganhou experiência?	Com IA e modelos de linguagens
o texto fala de rede neurais?	sim
o texto fala de inteligência artificial?	sim
o texto fala de automóveis?	não
o texto é publicitário?	não
o texto é acadêmico?	 não
o texto é um conto erótico?	não
o texto é um conto de terro?	não
o texto é positivo?	é neutro
o texto é negativo?	não
o texto é neutro?	 sim
quem é o autor do texto?	Não há essa informação
de quem é a autoria do texto?	 Não há essa informação.
de quando é o texto?	não há essa informação
qual a data do texto?	não há essa informação.
O texto fala dos Transformers?	O texto não tem referências à série de filmes Transformers
o texto fala dos Transformers?	não
