quais ativos o texto se refere?	VALE3, CSNA3, GGBR4, USIM5
quem escreveu o artigo?	Renan Dantas
quem escreveu o artigo?	o analista Renan Dantas
o artigo é de quem?	Renan Dantas
qual é a corretora do texto?	Itaú BBA
qual a corretora que o texto se refere?	Itaú BBA
segundo a corretora a Usiminas deve mostrar a maior melhora trismestral?	sim
segundo a corretora Itaú BBA qual ativo deve apresentar a maior melhora trismestral?	USIM5
a corretora Itaú BBA soltou relatório para que setor?	siderúrgicas
o Itaú espera queda no resultado da Vale?	sim
o Itaú espera alta no resultado da Vale?	Não
o itaú vê alguma melhora no preço do minério de ferro?	sim
os analistas do Itaú afirmam que a Vale deve lucrar quanto?	US$ 1,9 bilhão
os analistas do Itaú afirmam que a Vale deve lucrar quanto?	$1,9B
cite uma sugestão de leitura do texto.	itaúsa e dividendos
cite uma sugestão de leitura do texto.	Quer dividendos? Inclua Vale (VALE3) na carteira, recomenda Genial
os resultados de mineração devem aumentar sequencialmente?	sim
os resultados de mineração devem diminuir sequencialmente?	Não
segundo os analistas, a Usiminas apresentará resultados fortes?	sim
segundo os analistas, a Usiminas apresentará resultados fracos?	não
Vale é uma decepção conforme o Itaú BBA?	sim
segundo o Itaú BBA, quem deverá ser uma decepção?	a Vale
Vale é uma decepção conforme o Itaú BBA?	sim
segundo o Itaú BBA, quem deverá ser uma decepção e porque?	a Vale, porque segundo o Itaú BBA a Vale sofrerá queda nos seus resultados
A Gerdau é GGBR4?	sim
A Vale é VALE3?	sim
A Usiminas é USIM5?	sim
a CSN é CSNA3?	sim
a Gerdau é uma empresa de comodities?	sim
a Vale é uma empresa de comodities?	sim
a CSN é uma empresa de comodities?	sim
a Usiminas é uma empresa de comodities?	sim
o artigo é de quando?	08/04/2023 - 17:45
o artigo é de quando?	08 de Abril de 2023
o artigo é de quando?	08 de Abril
o artigo é de quando?	de 2023
o Itaú BBA recomenda compra na Usiminas?	sim
segundo o Itaú BBA, a CSN será uma decepção?	não, é esperado resultados fortes para a CSN
a imagem é de quem?	REUTERS/Stringer
Renan Dantas trabalha na Itaú BBA?	não, ele é o jornalista do texto
Renan Dantas trabalha na Itaú BBA?	não, ele é o analista do texto
Renan Dantas trabalha na Itaú BBA?	não, ele é o jornalista do artigo
Renan Dantas trabalha na Itaú BBA?	não, ele é o analista do artigo
foi Itaú BBA quem escreveu o texto?	não, foi Renan Dantas
foi Usiminas quem escreveu o texto?	não, foi Renan Dantas
foi a Vale quem escreveu o texto?	não, foi Renan Dantas
foi CSN quem escreveu o texto?	não, foi Renan Dantas
foi Gerdau quem escreveu o texto?	não, foi Renan Dantas
Gerdau é uma corretora?	não, ela é uma empresa de comodities
Usiminas é uma corretora?	não, ela é uma empresa de comodities
CSN é uma corretora?	não, ela é uma empresa de comodities
Vale é uma corretora?	não, ela é uma empresa de comodities
Itaú BBA é uma corretora?	sim
Itaú BBA é uma empresa de comodities?	não
o que é esperado pela Gerdau?	que ela se beneficie dos resultados no Brasil e nos EUA
o que é esperado pela CSN?	espera-se que ela registre um ligeiro aumento trimestral no Ebitda
o que é esperado para a Vale?	espera resultados fracos
o embarque de 57 milhões de toneladas de minério de ferro é da Gerdau?	não, é da Vale
o embarque de 57 milhões de toneladas de minério de ferro é da Usiminas?	não, é da Vale
o embarque de 57 milhões de toneladas de minério de ferro é da CSN?	não, é da Vale
o embarque de 57 milhões de toneladas de minério de ferro é maior que o do quarto trimestre anterior?	não, é menor
o embarque de 57 milhões de toneladas de minério de ferro é menor que o do quarto trimestre anterior?	sim, é menor
os resultados são de quando?	do primeiro trimestre
os resultados são de quando?	do primeiro trimestre de 2023
os resultados são de quando?	de Janeiro de 2023 a Março de 2023
segundo a corretora os resultados são mais favoráveis a quem?	Usiminas
segundo a corretora os resultados da Usiminas são melhores que da Vale?	sim
segundo a corretora os resultados da Usiminas são piores que da Vale?	não, a Vale é a decepção
o Itaú BBA faz uma previsão ou uma profecia?	previsão
os analistas são da Itaú BBA?	sim
os analistas trabalham no Itaú BBA?	sim
o Itaú BBA tem analistas?	sim
toda corretora tem analistas?	talvez
pelos cálculos dos analistas a Usiminas de apresentar um Ebitda de quanto?	R$ 755 milhões 
pelos cálculos dos analistas a Usiminas de apresentar um aumento do Ebitda de quantos porcento?	30%
é esperado da Usiminas um Ebitda de quanto?	R$ 755 milhões 
é esperado da Usiminas um aumento do Ebitda de quanto?	30%
30% de aumento de Ebitda é forte?	sim
30% de aumento de Ebitda é um resultado forte?	sim
30% de aumento de Ebitda é um resultado fraco?	não
30% de aumento de Ebitda é um fraco?	não
qual a previsão para CSN?	Resultados mais fortes
qual a previsão para Vale?	Mais uma decepção
qual a previsão para Gerdau?	se benificie dos resultados no Brasil e nos EUA
qual a previsão para a Usiminas?	Melhora sequencial
o que esperar das siderúrgicas no primeiro trimestre de 2023?	Um ótimo resultado da Usiminas e uma decepção da Vale
1T23 é de Janeiro de 2023 a Março de 2023?	sim
Janeiro de 2023 a Março de 2023 é 1T23?	sim
Janeiro de 2023 a Março de 2023 é igual a 1T23?	sim
que horas foi escrito o artigo?	17:45
o artigo foi escrito em que horário?	17:45
qual a última atualização do artigo?	08/04/2023 - 17:45
o artigo foi atualizado?	sim
o artigo foi atualizado por Renan Dantas?	sim
o artigo foi atualizado por Itaú BBA?	não
o artigo foi atualizado no primeiro trimestre?	não
China e Covid-19 são assuntos relevantes em 2023?	sim
2023 é uma era pós-pandemia?	sim
quem recomenda incluir Vale na carteira?	Genial
quem recomenda incluir VALE3 na carteira?	Genial
quais as tags do artigo?	Ações, Commodities, Comprar ou vender?, CSN, Gerdau, Itaú BBA, Mercados, Mineração, Resultados, Siderurgia, Usiminas, Vale	
o texto é de mineração?	sim
o texto é de Ações?	sim
o texto é de CSN?	sim
o texto é de Gerdau?	sim
o texto é de Vale?	sim
o texto é de Usiminas?	sim
o texto é de chocolate?	não
o texto é de minério de ferro?	sim
o texto é de minério de ouro?	não
o texto é de carvão?	não
Vale é sobre mineŕio de ferro?	sim
A variação no trimestre da Usiminas é de?	30.4%
o Ebitda da Usiminas é de	755 mi
a receita da Usiminas é de	7,732 bi
o lucro da Usiminas é de	536 mi
o lucro da Gerdau é de	1,774 bi
a receita da Gerdau é de	19,397 bi
o Ebitda da Gerdau é de	4,100 bi
qual o Ebitda da Usiminas?	755 mi
qual a receita da Usiminas?	7,732 bi
qual o lucro da Usiminas?	536 mi
qual o lucro da Gerdau?	1,774 bi
qual a receita da Gerdau?	19,397 bi
qual o Ebitda da Gerdau?	4,100 bi
qual o tick da Vale?	VALE3
qual o tick da Gerdau?	GGBR4
qual o tick da CSN?	CSNA3
qual o tick da Usiminas?	USIM5
o quarto trimestre de 2022 é	Outubro de 2022 a Dezembro de 2022
Outubro de 2022 a Dezembro de 2022 é	o quarto trimestre de 2022
Outubro de 2022 a Dezembro de 2022 é igual a 4T22?	sim
Outubro de 2022 a Dezembro de 2022 é igual a 1T23?	não
segundo o Itaú, em 1T23 quem vai brilhar?	A Usiminas
segundo o Itaú, em 1T23 quem vai decepcionar?	A Vale
o que está batendo as portas?	os resultados do primeiro trimestre de 2023
o que se arrastou por três meses, conforme o artigo?	a temporada de resultados do quarto trimestre de 2022
a Vale está entre as siderúrgicas?	sim
a Gerdau está entre as siderúrgicas?	sim
a Usiminas está entre as siderúrgicas?	sim
a CSN está entre as siderúrgicas?	sim
a Itaú BBA está entre as siderúrgicas?	não
a Vale está entre as corretoras?	não
a Gerdau está entre as corretoras?	não
a Usiminas está entre as corretoras?	não
a CSN está entre as corretoras?	não
a Itaú BBA está entre as corretoras?	sim
escreva um artigo do mercado de capitais para as ações VALE3, CSNA3, GGBR4, USIM5	<|answer|>
Preciso de um exemplo de artigo sobre os ativos VALE3, CSNA3, GGBR4, USIM5	<|answer|>
faça um texto jornalistico da área de bolsa de valores	<|answer|>