o texto é em primeira pessoa?	não
o texto é em primeira pessoa?	não, ele é em terceira pessoa
qual o assunto do texto?	o livro "Os Elementos"
o texto trata do que?	o livro "Os Elementos"
o texto fala da Bíblia?	não, a Bíblia é apenas citada comparativamente
o livro "Os Elementos" é o livro mais reproduzido e estudado na história do mundo ocidental?	não, como o texto afirma o primeiro é a Bíblia
de trata o livro "Os Elementos"?	de matemática e geometria
segundo o texto, qual foi o texto mais influente de todos os tempos?	o livro "Os Elementos"
ordene por ordem de reprodução e estudos os livros citados no texto	Bíblia, Os Elementos
ordene inversamente por ordem de reprodução e estudos os livros citados no texto	Os Elementos, Bíblia
qual obra é considerada, conforme o texto, um dos maiores best-sellers?	Os Elementos
A obra é admirada pelos matemáticos?	sim
A obra é admirada pelos filósofos?	sim
A obra "Os Elementos" é admirada pelos matemáticos?	sim
A obra "Os Elementos" é admirada pelos filósofos?	sim
o livro "Os Elementos" fala de luminosidade?	não
Os Elementos é um modelo lógico para o quê?	todas a ciências físicas
porque Os Elementos é considerado um modelo lógico para todas a ciências físicas?	pelo rigor das demonstrações e pela maneira como são postas as bases da geometria
como os sucessores de Euclides chamavam o livro "Os Elementos"?	elementador
conforme o texto, Os Elementos foi o mais estudado no mundo?	o texto cita apenas o mundo ocidental
o autor do texto tem atitude positiva com o livro "Os Elementos"?	sim
o autor do texto tem atitude negativa com o livro "Os Elementos"?	não
cite um trecho que demonstra entusiasmo do autor do texto	"Foi o texto mais influente de todos os tempos"
"todos os tempos", "todos os países", "história do mundo ocidental", esses trechos exaltam o assunto?	sim.
"todos os tempos", "todos os países", "história do mundo ocidental", esses trechos fazem relação somente com o tempo cronológico?	não, o trecho "todos os países" tem relação com o espaço
"todos os tempos", "todos os países", "história do mundo ocidental", esses trechos fazem relação somente com o espaço físico?	não, os trechos "todos os tempos" e "história do mundo ocidental" têm relação com o tempo cronológico
Escreva um pequeno texto sobre "Os Elementos" de Euclides	<|answer|>
fale-me algo sobre o livro os Elementos	<|answer|>
porque os elementos é tão famoso?	<|answer|>
alguém ainda lê o livro os elementos de Euclides?	<|answer|>
qual o livro mais famoso de matemática?	<|answer|>
qual o livro mais famoso depois da biblia?	<|answer|>