Qual é o tema principal dos artigos mais lidos?	O ensino de matemática e educação matemática.
Quantos artigos foram listados?	Foram listados 20 artigos.
Qual é o artigo mais lido?	"Representações Múltiplas no ensino de Álgebra e Resolução de Problemas: aspectos teóricos e práticos", com 548 leituras.
Qual é o segundo artigo mais lido?	"Teoria da Objetivação: reflexões sobre o engajamento nas aulas de matemática para uma aprendizagem colaborativa", com 474 leituras.
Quais são as leituras do terceiro artigo mais lido?	"SITUACIÓN ACTUAL DE LA EDUCACIÓN MATEMÁTICA EN EL PERÚ" teve 252 leituras.
Qual é o quarto artigo mais lido?	"Inovação pedagógica sob a perspectiva dos estilos de aprendizagem: uma revisão sistemática de literatura", com 243 leituras.
Quais são as possibilidades de uso da fotografia no ensino de matemática?	"Fotografia no ensino de matemática: algumas possibilidades" discute possibilidades de uso da fotografia no ensino de matemática.
Quantas leituras teve o artigo "Tecnologias Digitais em Educação Matemática: panorama dos Grupos de Pesquisa do Paraná"?	Esse artigo teve 229 leituras.
Qual é a função do ensino da matemática na formação do indivíduo e de sua cidadania na educação?	O ensino da matemática tem a função de contribuir para a formação do indivíduo e sua cidadania na educação.
Quantas leituras teve o artigo "Educação Menor Como Dispositivo Potencializador De Uma Escola Outra"?	Esse artigo teve 219 leituras.
O que são os "Instrumentos de cálculo contidos em tratados do século XVII"?	São objetos que atravessaram os tempos e são discutidos nesse artigo.
Como as linhas de partes iguais do compasso de proporção (1631) podem ser compreendidas?	Elas podem ser compreendidas pelo teorema de proporcionalidade, conforme discutido no artigo.
Qual é o tema do artigo "A FORMAÇÃO DO PROFESSOR DE MATEMÁTICA: PRÁTICAS E PESQUISA"?	O tema desse artigo é a formação do professor de matemática.
O que são os obstáculos epistemológicos no desenvolvimento da cognição matemática na escola?	São reflexões discutidas nesse artigo.
Qual é a perspectiva adotada no artigo "A Teoria Histórico-Cultural na perspectiva da Educação Matemática"?	A perspectiva adotada nesse artigo é a Teoria Histórico-Cultural.
O que é discutido no artigo "Educação Financeira Escolar: reflexões para tomada de decisões diante de experiências financeiras"?	Esse artigo discute reflexões sobre a educação financeira escolar e a tomada de decisões diante de experiências financeiras.
Quais são as revelações das pesquisas acadêmicas sobre o coordenador pedagógico e as manifestações dos conhecimentos matemáticos?	Esse artigo discute as revelações das pesquisas acadêmicas sobre o tema.
O que é analisado no artigo "Os meios semióticos de objetivação e o pensamento algébrico"?	É feita uma análise à luz da Teoria da Objetivação.
O que é discutido no artigo sobre obstáculos epistemológicos inerentes ao conceito de fração?	Esse artigo discute o estado do conhecimento sobre os obstáculos epistemológicos inerentes ao conceito de fração.
Quais são os critérios para desenhar tarefas que desenvolvam o raciocínio algebraico fundamental?	Esses critérios são discutidos no artigo "Criterios para diseñar tareas que desarrollen el razonamiento algebraico elemental".
Qual é o último artigo da lista?	"O letramento matemático nos anos iniciais do ensino fundamental"
Qual o número de leituras do primeiro artigo?	548
Qual o número de leituras do segundo artigo?	474
Qual o número de leituras do terceiro artigo?	252
Qual o número de leituras do quarto artigo?	243
Qual o número de leituras do quinto artigo?	241
Qual o número de leituras do sexto artigo?	229
Qual o número de leituras do sétimo artigo?	221
Qual o número de leituras do oitavo artigo?	219
Qual o número de leituras do nono artigo?	214
Qual o número de leituras do décimo artigo?	213
Qual o número de leituras do décimo primeiro artigo?	195
Qual o número de leituras do décimo segundo artigo?	187
Qual o número de leituras do décimo terceiro artigo?	174
Qual o número de leituras do décimo quarto artigo?	165
Qual o número de leituras do décimo quinto artigo?	157
Qual o número de leituras do décimo sexto artigo?	155
Qual o número de leituras do décimo sétimo artigo?	153
Qual o número de leituras do décimo oitavo artigo?	150
Qual o número de leituras do décimo nono artigo?	145
Qual o número de leituras do vigésimo artigo?	143


