Qual é o objetivo dos epistemólogos?	O objetivo dos epistemólogos é oferecer uma abordagem substancial e explicativa das condições nas quais uma crença tem algum status epistêmico desejável.
Que tipo de status epistêmico é desejável para uma crença?	o status epistêmico desejável para uma crença geralmente inclui justificação e conhecimento.
O que os epistemólogos levam em conta de acordo com a perspectiva confiabilista?	De acordo com o ponto de vista confiabilista, qualquer teoria epistemológica adequada deve levar em conta a confiabilidade do processo responsável pela crença.
Quais considerações são relevantes quando se trata da verocondutibilidade?	Considerações acerca da verocondutibilidade, que se refere à confiabilidade do processo de obtenção da crença, também devem ser levadas em conta.
O que seria necessário para uma teoria epistemológica ser considerada adequada do ponto de vista confiabilista?	Uma teoria epistemológica seria considerada adequada do ponto de vista confiabilista se levasse em conta a confiabilidade do processo responsável pelas crenças e considerações acerca da verocondutibilidade.
Quais são algumas das condições epistêmicas desejáveis mencionadas no texto?	Algumas das condições epistêmicas desejáveis mencionadas no texto são justificação e conhecimento.
Quais são os dois autores mencionados no texto?	Os dois autores mencionados no texto são Alvin Goldman e Bob Beddor.
Qual é o papel dos epistemólogos em relação às crenças?	O papel dos epistemólogos é oferecer uma abordagem substancial e explicativa das condições nas quais uma crença tem algum status epistêmico desejável.
O que é confiabilidade de acordo com o ponto de vista confiabilista?	De acordo com o ponto de vista confiabilista, confiabilidade refere-se à confiabilidade do processo responsável pela crença.
O que significa verocondutibilidade?	Verocondutibilidade refere-se à confiabilidade do processo de obtenção da crença.
Quais são algumas das considerações que uma teoria epistemológica adequada deve levar em conta?	Uma teoria epistemológica adequada deve levar em conta a confiabilidade do processo responsável pelas crenças e considerações acerca da verocondutibilidade.
Quais são os principais objetivos dos epistemólogos mencionados no texto?	Os principais objetivos dos epistemólogos mencionados no texto são oferecer uma abordagem substancial e explicativa das condições nas quais uma crença tem algum status epistêmico desejável, como justificação e conhecimento.
Quais são os dois tipos de status epistêmico mencionados no texto?	Os dois tipos de status epistêmico mencionados no texto são justificação e conhecimento.
O que é necessário para que uma crença tenha algum status epistêmico desejável?	Uma crença deve atender a certas condições, como justificação e conhecimento, para ter algum status epistêmico desejável.
O que é levado em conta no ponto de vista confiabilista?	No ponto de vista confiabilista, a confiabilidade do processo responsável pela crença e considerações acerca da verocondutibilidade são levados em conta.
quem é o autor do texto?	São dois autores, Alvin Goldman e Bob Beddor
QUEM É O AUTOR DO TEXTO?	São dois autores, Alvin Goldman e Bob Beddor
QUEM FEZ A TRADUÇÃO DO ORIGINAL?	L. H. Marques Segundo
liste os nomes contidos no texto	L. H. Marques Segundo, Alvin Goldman e Bob Beddor
qual a língua original do texto?	Não é possível inferir com as informações dadas